`  `  `  `  `  `  `  `  `  `  `  `  `  `  `
`  `  `  `  `  `  *  *  `  `  `  `  `  `  `
`  `  ^  ^  ^  `  `  `  "  "  "  "  "  *  `
`  `  `  ^  ^  ^  `  `  "  ~  ~  ~  "  *  `
`  `  `  `  `  `  `  `  "  ~  ~  ~  "  "  `
`  `  `  `  `  `  `  `  "  ~  ~  ~  ~  "  `
`  *  `  `  ░  ░  `  `  "  ~  ~  ~  ~  "  `
`  *  `  `  ░  ░  `  `  "  "  ~  ~  "  "  `
`  `  `  `  `  ░  ░  `  `  "  ~  ~  "  `  `
`  `  `  `  `  ░  ░  `  `  "  "  "  "  `  `
`  `  `  `  `  `  `  `  `  `  `  `  `  `  `
`  `  `  ^  ^  `  `  `  `  `  `  `  `  `  `
`  `  `  ^  ^  `  `  `  `  *  *  `  `  `  `
`  `  `  `  `  `  `  `  `  `  `  `  `  `  `
`  `  `  `  `  `  `  `  `  `  `  `  `  `  `

