```````````````
``````**```````
``^^^```"""""*`
```^^^``"~~~"*`
````````"~~~""`
````````"~~~~"`
`*``░░``"~~~~"`
`*``░░``""~~""`
`````░░``"~~"``
`````░░``""""``
```````````````
```^^``````````
```^^````**````
```````````````
```````````````

